5 4 5 5 17 3 0 5 5 5 5 44 5
5 0 22 5 0 2 0 0 0 5 5 33 0
3 0 0 0 0 1 15 1 0 0 0 22 0
0 1 1 1 0 3 0 22 16 1 0 0 0
13 1 0 0 18 1 0 1 0 0 0 1 11
0 0 0 1 0 22 0 3 0 1 1 1 3
0 22 33 0 0 1 12 1 0 0 0 0 0
0 0 5 5 5 0 0 2 14 5 22 0 5
5 44 5 5 5 5 5 3 5 5 5 4 5
