5 4 5 5 0 3 0 5 5 5 5 4 5
5 0 2 5 0 2 0 0 0 5 5 3 5
3 0 0 0 0 1 0 1 0 0 0 2 0
0 1 1 1 0 3 0 2 0 1 0 0 0
0 1 0 0 0 1 0 1 0 0 0 1 0
0 0 0 1 0 2 0 3 0 1 1 1 3
0 2 3 0 0 1 0 1 0 0 0 0 0
5 0 5 5 5 0 0 2 0 5 2 0 5
5 4 5 5 5 5 5 3 5 5 5 5 4
